# VEF Tags
EGY = "countries/Egypt.txt"
ADL = "countries/AlAndalus.txt"
FLR = "countries/FlorentineRepublic.txt"
PAD = "countries/Padua.txt"
SAN = "countries/Sandomierz.txt"
KAL = "countries/Kaliz.txt"
VOL = "countries/Volhynia.txt"
YOT = "countries/Yotvings.txt"
PTV = "countries/Pinsk-Turov.txt"
KIV = "countries/Kiev.txt"
CHR = "countries/Chernigov.txt"
NSV = "countries/NovgorodSeversk.txt"
VLD = "countries/VladimirSuzdal.txt"
UST = "countries/Ustyug.txt"
BZK = "countries/Beloozersk.txt"
GLH = "countries/Galich.txt"
VIA = "countries/Viatka.txt"
MJC = "countries/Majorca.txt"
CTH = "countries/Carinthia.txt"
TLM = "countries/Tlemcen.txt"
YUN = "countries/Yuan.txt"
TEX = "countries/Texas.txt"
NWZ = "countries/NewZealand.txt"
BTR = "countries/BatavianRepublic.txt"
URU = "countries/Uruguay.txt"
BOL = "countries/Bolivia.txt"
SCL = "countries/KingdomTwoSicilies.txt"
ILK = "countries/IlKhanate.txt"
CBN = "countries/Chobanids.txt"
INJ = "countries/Injuids.txt"
MZF = "countries/Muzaffarids.txt"
SRB = "countries/Sarbadars.txt"
CLT = "countries/CelticEmpire.txt"
CSA = "countries/Confederacy.txt"
UGL = "countries/Uglich.txt"
KOS = "countries/Kostroma.txt"
KUJ = "countries/Kujavia.txt"
GLO = "countries/Glogow.txt"
RAT = "countries/Ratibor.txt"
LGN = "countries/Legnica.txt"
OPO = "countries/Opole.txt"
LUC = "countries/Lucca.txt"
VIC = "countries/VictualBros.txt"
IMR = "countries/Imereti.txt"
KAK = "countries/Kakheti.txt"
KKH = "countries/Karakhanid.txt"
KSG = "countries/Kashgaria.txt"
BSH = "countries/Bashkiria.txt"
VOG = "countries/Vogtland.txt"
BEL = "countries/BelgianKingdom.txt"
KLI = "countries/Kartli.txt"
EGM = "countries/EyaletofEgypt.txt"
SLV = "countries/Slovenia.txt"
RMG = "countries/Romagna.txt"
WRO = "countries/Wroclaw.txt"
GVL = "countries/GreatVlachia.txt"
ANV = "countries/AngevinEmpire.txt"
BHR = "countries/Bharat.txt"
ROM = "countries/RomanEmpire.txt"
WLN = "countries/Wallonia.txt"
KRD = "countries/Kurdistan.txt"
RUM = "countries/Rum.txt"
HMD = "countries/Hamidids.txt"
PQR = "countries/RomanRepublic.txt"
AQU = "countries/Aquileia.txt"
ADR = "countries/Andorra.txt"
SNM = "countries/SanMarino.txt"
MSK = "countries/Mossi.txt"
ALW = "countries/Nubia.txt"
NDO = "countries/Ndongo.txt"
CRD = "countries/Cordoba.txt"
LEO = "countries/Leon.txt"
TOL = "countries/Toledo.txt"
SEV = "countries/Sevilla.txt"
VDN = "countries/Vidin.txt"
KRV = "countries/Karvuna.txt"
CTG = "countries/Carthage.txt"
ITO = "countries/Ito.txt"
SAG = "countries/Sagara.txt"
SHN = "countries/Shoni.txt"
KIK = "countries/Kikkawa.txt"
MIY = "countries/Miyoshi.txt"
HTT = "countries/Hattori.txt"
OGY = "countries/Ogigayatsu.txt"
KTE = "countries/Kitabatake.txt"
JNB = "countries/Jinbo.txt"
KIO = "countries/Kiso.txt"
MUR = "countries/Murakami.txt"
SGO = "countries/Sogo.txt"
STO = "countries/Saito.txt"
SMI = "countries/Satomi.txt"
ANK = "countries/Anegakori.txt"
YMI = "countries/Yamanouchi.txt"
STK = "countries/Satake.txt"
MGI = "countries/Mogami.txt"
ASN = "countries/Ashina.txt"
BHO = "countries/Bessho.txt"
KNO = "countries/Kono.txt"
MPH = "countries/PhulkianMisl.txt"
MBH = "countries/BhangiMisl.txt"
MKY = "countries/KanheyaMisl.txt"
MRM = "countries/RamgarhiaMisl.txt"
MSG = "countries/SinghpuriaMisl.txt"
MPA = "countries/PanjgarhiaMisl.txt"
MNI = "countries/NishanwaliaMisl.txt"
MSU = "countries/SuperchackiaMisl.txt"
MDW = "countries/DallewaliaMisl.txt"
MNK = "countries/NakaiMisl.txt"
IBE = "countries/IberianUnion.txt"
SCN = "countries/Scania.txt"
DJE = "countries/Djenne.txt"
GAO = "countries/Gao.txt"
TBK = "countries/Timbuktu.txt"
KSN = "countries/Katsina.txt"
ZZZ = "countries/Zazzau.txt"
KAN = "countries/Kano.txt"
THL = "countries/Thule.txt"
NUP = "countries/Nupe.txt"
ANU = "countries/Ainu.txt"
FRY = "countries/MagnaFrisia.txt"
X01 = "countries/Mongols.txt"
SIK = "countries/SikhEmpire.txt"
PNG = "countries/Penguintopia.txt" # Easter Egg country!
NSE = "countries/NorthSeaUnion.txt"
ISC = "countries/IrishScottishConfederacy.txt"
ARB = "countries/Arabia.txt"
NRI = "countries/Nri.txt"
MRV = "countries/Maravi.txt"
DAW = "countries/Dawaro.txt"
MDB = "countries/MedriBahri.txt"
WAR = "countries/Warsangali.txt"
MAK = "countries/Makuria.txt"
DAH = "countries/FonStates.txt"
KNG = "countries/Kong.txt"
BEJ = "countries/Bejaia.txt"
RIM = "countries/Rimini.txt"
FOR = "countries/Forli.txt"
ANC = "countries/Ancona.txt"
MSC = "countries/Massa.txt"
PIO = "countries/Piombino.txt"
SAL = "countries/Saluzzo.txt"
MYO = "countries/Mayo.txt"
GLW = "countries/Galway.txt"
PAH = "countries/Pahang.txt"
SGP = "countries/Singapura.txt"

# SI Tags
MFT = "countries/Montferrat.txt"
BLG = "countries/Bologna.txt"

# Tags from neon
AVA = "countries/Ava.txt"
KDH = "countries/Kedah.txt"
KUT = "countries/Kutei.txt"
PLM = "countries/Palembang.txt"
SUN = "countries/Sunda.txt"
RAJ = "countries/Rajasthan.txt"
MLD = "countries/Maldive.txt"
AUS = "countries/Australia.txt"
JAF = "countries/Jaffna.txt"
DLI = "countries/Dali.txt"
PGN = "countries/Pagan.txt"
SHS = "countries/Singhasari.txt"
SVJ = "countries/Srivijaya.txt"
HIN = "countries/Hindustan.txt"

# MPN Tags
YUE = "countries/Yue.txt"
SHU = "countries/Shu.txt"
XNG = "countries/Xiang.txt"
LNG = "countries/Liang.txt"
YDU = "countries/Yidu.txt"
LIA = "countries/Liao.txt"

RMV = "countries/RomuvanEmpire.txt"
JOM = "countries/Jomsvikings.txt"
KRL = "countries/Karelia.txt"
ICE = "countries/Iceland.txt"
GRN = "countries/Greenland.txt"
RHO = "countries/Rhodes.txt"
LAE = "countries/LatinEmpire.txt"
HTM = "countries/Hetmanshina.txt"
DON = "countries/Don.txt"

#Anatolian Minors
KRS = "countries/Karesi.txt"
TAV = "countries/Tavas.txt"
LAD = "countries/Ladik.txt"
SAH = "countries/Sahipata.txt"
GRM = "countries/Germiyan.txt"
TEK = "countries/Tekke.txt"
ESH = "countries/Eshref.txt"
ALA = "countries/Alaiye.txt"
GNY = "countries/Gonyuk.txt"
ANA = "countries/Ankara.txt"
PRV = "countries/Pervane.txt"
CIL = "countries/Cilicia.txt"
SAM = "countries/Samtskhe.txt"
OSM = "countries/Osman.txt"

